2 3 3 3 3 3 3 3 3 3 3 3 3 3 3 3 3 3 3 4 
2 0 0 0 0 0 0 0 0 0 0 0 0 0 0 0 0 0 0 4 
2 0 0 0 0 11 0 0 0 0 0 0 0 0 0 0 0 0 0 4 
2 0 0 0 0 12 0 0 0 0 17 1 1 1 1 7 0 0 0 4 
2 0 0 0 0 12 0 0 0 20 0 5 3 3 9 2 0 0 0 4 
2 0 0 0 0 10 0 0 0 11 0 0 0 0 5 8 0 0 0 4 
2 0 0 0 0 20 0 0 0 12 0 0 0 0 0 0 0 0 0 4 
2 0 0 0 0 0 0 0 0 12 0 0 0 0 0 0 0 0 0 4 
2 0 0 0 0 0 0 0 0 10 0 0 0 0 0 0 0 0 0 4 
2 0 0 0 0 0 0 0 0 0 0 0 0 0 0 0 0 0 0 4 
2 26 0 0 0 0 0 0 0 0 0 0 0 0 0 0 0 0 25 4 
18 18 18 18 18 18 22 22 22 18 18 18 22 22 22 18 18 18 18