3 3 3 3 3 3 3 3 3 3 3 3 3 3 3 3 3 3 3 3 
12 0 0 0 0 0 0 0 0 0 0 0 0 0 0 0 0 0 0 12 
12 0 0 0 0 0 0 0 0 0 0 0 0 0 0 0 0 0 25 12 
12 0 0 0 0 0 0 0 0 0 0 0 0 0 0 0 17 18 18 12 
12 0 0 0 0 0 0 0 0 0 0 0 0 21 0 0 0 0 0 12 
12 0 0 0 0 0 0 0 0 0 0 0 0 0 0 0 0 0 0 12 
12 0 0 0 0 20 0 17 1 1 1 7 0 0 0 0 0 0 0 12 
12 0 0 0 0 0 0 0 5 9 9 2 0 0 0 0 0 0 0 12 
12 0 0 0 0 0 0 0 0 5 23 8 0 0 0 0 0 0 0 12 
12 0 0 0 0 0 0 0 0 0 0 0 0 0 0 0 0 0 0 12 
12 26 0 0 0 0 0 0 0 0 0 0 0 0 0 0 24 0 0 12 
1 1 1 1 1 1 22 22 22 22 22 1 1 1 1 1 1 1 1 1