11 0 0 0 0 0 0 0 0 0 0 0 0 0 0 0 0 0 0 3 
12 0 0 0 0 0 0 0 0 0 0 0 0 0 0 0 0 0 0 12 
12 0 0 0 0 11 0 0 0 11 0 0 0 0 0 0 0 0 0 12 
12 0 0 0 4 12 0 0 0 12 18 18 18 18 7 0 0 6 18 12 
12 0 0 0 0 12 0 0 0 12 0 0 0 0 12 0 0 0 0 12 
12 0 0 0 0 12 0 0 0 12 0 0 0 0 12 0 0 0 0 12 
12 0 0 0 0 12 0 0 0 12 0 0 0 0 12 0 0 0 0 12 
12 0 0 0 0 12 0 0 0 10 0 0 0 0 12 0 0 0 0 12 
12 0 0 0 0 12 0 0 0 0 0 0 0 0 12 0 0 0 0 12 
12 0 0 0 0 12 0 0 0 0 0 0 0 0 12 0 0 0 0 12 
12 0 24 0 0 12 0 0 0 0 0 0 0 25 2 22 22 0 26 12 
1 1 1 22 22 1 22 22 22 22 1 1 1 1 1 1 1 1 1 1